111111111111
1P0C0000C0E1
111111111111