1111111111
1P000000C1
1111111101
1C00000101
1011110101
101E00C101
1011111101
1C000000C1
1111111111